11111111111111111111111111111111111111111
S0000000000000000000001000001000000000001
10111110111111111110101110101011111111101
10100010001000000000101000100010000010001
10101011111011111111101011111111101110111
10101000001000100010000010000000100010001
10101111101110101011111110101110111011101
10101000100000101000100010101000000000101
11101011101111101111101010101110111111101
10001000101000101000001000100010100010001
10111010101010101011111111111011101010111
10001010001010001000100000101000001000101
11101011111011111110101110101111111111101
10001000100010000010001010001000000000001
10111111101111101011111011101111111110101
10000000001000001000000000100010000000101
11111111111010101111111110111010111111101
10000000100010101000000010001010100000101
10101110101110111011101011101010101110101
10100000100010000000101000101000101000101
10111110111011101111101011101111101011101
10100010100010000010001000001000001000001
10101110101110111010111011111011111111111
10101000101000101010001010001000100000001
10101010101110101011101110101110101111101
10101010100010001000100000100000100000101
10101011111010111110111111111111101110101
10101000001010100010000010000000101000101
10101111101011101010111110111110101011101
10100000101000001010000000100010001000101
10111110101111111010111111101011111110101
10000000100000001010000010001000100000101
11111110111110101011111010111111101111101
10001000100000101010100010100010001010001
10101111101111111010101110101010111010111
10100000001000000010000000101010100010001
10111111101011111111111011101010101011101
10100010001010000010001010001010101000101
10101011111010111010101110111010101010101
1000100000000010000010000010000000001000E
11111111111111111111111111111111111111111